WWWWWWWWWWWWWWWWWWWWWWWW
W                      W
W                      W
W                      W
W    WWWWWWW           W
W                      W
W         P            W
W                      W
WWWWWWWWWWWWWWWWWWWWWWWW