WWWWWWWWWWWWWWWWWWWWWWWW
W        W     W       W
W    WWWWW   WWWW      W
W      W        WW   WWW
W    WWWWWWW           W
W              WWWW    W
W         P    W       W
W                      W
WWWWWWWWWWWWWWWWWWWWWWWW