11111111111
12000100001
10111110111
10010010001
10111011101
10000000001
11111111111